[
  [ 7,  7,  7,  7,  7,  7,  7,  7,  7,  7,  7,  7,  7,  7,  7,  7,  7,  7,  7,  7,  7,  7,  7,  7,  7,  7,  7,  7],
  [ 7,  7,  7,  7,  7,  7,  7,  7,  7,  7,  7,  7,  7,  7,  7,  7,  7,  7,  7,  7,  7,  7,  7,  7,  7,  7,  7,  7],
  [ 7,  7,  7,  7,  7,  7,  7,  7,  7,  7,  7,  7,  7,  7,  7,  7,  7,  7,  7,  7,  7,  7,  7,  7,  7,  7,  7,  7],
  [ 3,  9,  9,  9,  9,  9,  9,  9,  9,  9,  9,  9,  9, 30, 31,  9,  9,  9,  9,  9,  9,  9,  9,  9,  9,  9,  9, 15],
  [ 4, 20, 20, 20, 20, 20, 20, 20, 20, 20, 20, 20, 20,  1, 13, 20, 20, 20, 20, 20, 20, 20, 20, 20, 20, 20, 20, 16],
  [ 4, 20,  0,  6,  6, 12, 20,  0,  6,  6,  6, 12, 20,  1, 13, 20,  0,  6,  6,  6, 12, 20,  0,  6,  6, 12, 20, 16],
  [ 4, 26,  1,  7,  7, 13, 20,  1,  7,  7,  7, 13, 20,  1, 13, 20,  1,  7,  7,  7, 13, 20,  1,  7,  7, 13, 26, 16],
  [ 4, 20,  2,  8,  8, 14, 20,  2,  8,  8,  8, 14, 20,  2, 14, 20,  2,  8,  8,  8, 14, 20,  2,  8,  8, 14, 20, 16],
  [ 4, 20, 20, 20, 20, 20, 20, 20, 20, 20, 20, 20, 20, 20, 20, 20, 20, 20, 20, 20, 20, 20, 20, 20, 20, 20, 20, 16],
  [ 4, 20,  0,  6,  6, 12, 20,  0, 12, 20,  0,  6,  6,  6,  6,  6,  6, 12, 20,  0, 12, 20,  0,  6,  6, 12, 20, 16],
  [ 4, 20,  2,  8,  8, 14, 20,  1, 13, 20,  2,  8,  8, 24, 18,  8,  8, 14, 20,  1, 13, 20,  2,  8,  8, 14, 20, 16],
  [ 4, 20, 20, 20, 20, 20, 20,  1, 13, 20, 20, 20, 20,  1, 13, 20, 20, 20, 20,  1, 13, 20, 20, 20, 20, 20, 20, 16],
  [ 5, 11, 11, 11, 11, 12, 20,  1, 19,  6,  6, 12,  7,  1, 13,  7,  0,  6,  6, 25, 13, 20,  0, 11, 11, 11, 11, 17],
  [ 7,  7,  7,  7,  7,  4, 20,  1, 18,  8,  8, 14,  7,  2, 14,  7,  2,  8,  8, 24, 13, 20, 16,  7,  7,  7,  7,  7],
  [ 7,  7,  7,  7,  7,  4, 20,  1, 13,  7,  7,  7,  7,  7,  7,  7,  7,  7,  7,  1, 13, 20, 16,  7,  7,  7,  7,  7],
  [ 7,  7,  7,  7,  7,  4, 20,  1, 13,  7, 21, 11, 23, 10, 10, 29, 11, 27,  7,  1, 13, 20, 16,  7,  7,  7,  7,  7],
  [ 9,  9,  9,  9,  9, 14, 20,  2, 14,  7, 16,  7,  7,  7,  7,  7,  7,  4,  7,  2, 14, 20,  2,  9,  9,  9,  9,  9],
  [ 7,  7,  7,  7,  7,  7, 20,  7,  7,  7, 16,  7, -2, -2, -2, -2,  7,  4,  7,  7,  7, 20,  7,  7,  7,  7,  7,  7],
  [11, 11, 11, 11, 11, 12, 20,  0, 12,  7, 16,  7,  7,  7,  7,  7,  7,  4,  7,  0, 12, 20,  0, 11, 11, 11, 11, 11],
  [ 7,  7,  7,  7,  7,  4, 20,  1, 13,  7, 22,  9,  9,  9,  9,  9,  9, 28,  7,  1, 13, 20, 16,  7,  7,  7,  7,  7],
  [ 7,  7,  7,  7,  7,  4, 20,  1, 13,  7,  7,  7,  7, -1,  7,  7,  7,  7,  7,  1, 13, 20, 16,  7,  7,  7,  7,  7],
  [ 7,  7,  7,  7,  7,  4, 20,  1, 13,  7,  0,  6,  6,  6,  6,  6,  6, 12,  7,  1, 13, 20, 16,  7,  7,  7,  7,  7],
  [ 3,  9,  9,  9,  9, 14, 20,  2, 14,  7,  2,  8,  8, 24, 18,  8,  8, 14,  7,  2, 14, 20,  2,  9,  9,  9,  9, 15],
  [ 4, 20, 20, 20, 20, 20, 20, 20, 20, 20, 20, 20, 20,  1, 13, 20, 20, 20, 20, 20, 20, 20, 20, 20, 20, 20, 20, 16],
  [ 4, 20,  0,  6,  6, 12, 20,  0,  6,  6,  6, 12, 20,  1, 13, 20,  0,  6,  6,  6, 12, 20,  0,  6,  6, 12, 20, 16],
  [ 4, 20,  2,  8, 24, 13, 20,  2,  8,  8,  8, 14, 20,  2, 14, 20,  2,  8,  8,  8, 14, 20,  1, 18,  8, 14, 20, 16],
  [ 4, 26, 20, 20,  1, 13, 20, 20, 20, 20, 20, 20, 20, 20, 20, 20, 20, 20, 20, 20, 20, 20,  1, 13, 20, 20, 26, 16],
  [32,  6, 12, 20,  1, 13, 20,  0, 12, 20,  0,  6,  6,  6,  6,  6,  6, 12, 20,  0, 12, 20,  1, 13, 20,  0,  6, 34],
  [33,  8, 14, 20,  2, 14, 20,  1, 13, 20,  2,  8,  8, 24, 18,  8,  8, 14, 20,  1, 13, 20,  2, 14, 20,  2,  8, 35],
  [ 4, 20, 20, 20, 20, 20, 20,  1, 13, 20, 20, 20, 20,  1, 13, 20, 20, 20, 20,  1, 13, 20, 20, 20, 20, 20, 20, 16],
  [ 4, 20,  0,  6,  6,  6,  6, 25, 19,  6,  6, 12, 20,  1, 13, 20,  0,  6,  6, 25, 19,  6,  6,  6,  6, 12, 20, 16],
  [ 4, 20,  2,  8,  8,  8,  8,  8,  8,  8,  8, 14, 20,  2, 14, 20,  2,  8,  8,  8,  8,  8,  8,  8,  8, 14, 20, 16],
  [ 4, 20, 20, 20, 20, 20, 20, 20, 20, 20, 20, 20, 20, 20, 20, 20, 20, 20, 20, 20, 20, 20, 20, 20, 20, 20, 20, 16],
  [ 5, 11, 11, 11, 11, 11, 11, 11, 11, 11, 11, 11, 11, 11, 11, 11, 11, 11, 11, 11, 11, 11, 11, 11, 11, 11, 11, 17],
  [ 7,  7,  7,  7,  7,  7,  7,  7,  7,  7,  7,  7,  7,  7,  7,  7,  7,  7,  7,  7,  7,  7,  7,  7,  7,  7,  7,  7],
  [ 7,  7,  7,  7,  7,  7,  7,  7,  7,  7,  7,  7,  7,  7,  7,  7,  7,  7,  7,  7,  7,  7,  7,  7,  7,  7,  7,  7]
]